WWWWWWW
WB   PW
W     W
W  V  W
W     W
W A A W
WWWWWWW