WWWWWWWWWWWWWWWWWWWWWWWWWWWWWWWWWWWWWWWWW
W                              W        W
WWWW        WWWWWWWWWWW        W        W
WA             H               W        W
W          WWWWW               W        W
W H                 WWWWWWWWWWWW       WW
WWWWWWWWWWWWWWWWV                       W
W                                   H   W
WW          WWWWWWWWWWWWWWWWWW          W
WP                           H          W
WWWWWWWWWWWWWWWWWWWWWWWWWWWWWW          W
W       W                   W           W
W       W      W            WWWWWWWW    W
W              W                  AW    W
W                                WWW    W
W           WWWWWWWW                  V W
WWWWWWWWWWWWWWWWWWWWWWWWWWWWWWWWWWWWWWWWW