WWWWWWWWWWWWWWWWWWWW
W                 VW
W       H          W
W       AH         W
W      H           W
W                 VW
WWWWWWWWWWWWWWWWWW W
W                  W
W WWWWWWWWWWWWWWWWWW
W H                W
W                 HW
WWWWWWWWWWWWWWWWW  W
W               H  W
W                  W
W                  W
WVWWWWWWWWWWWWWWWWWW
W                  W
WWWWWWWWWWWWWWWWH  W
WPB                W
WWWWWWWWWWWWWWWWWWWW