WWWWWWWWWWWWWWWWWWWWWWWWWWWWWW
W   HW    A   AW    V   W W  W
W   W H  W W  W W  W W  A W  W
W   WW   W H  BH   W W       W
W   W W  WWA  W W  WWW  W W  W
WP  WW   B W  BA   W W  W W  W
W W  V WWWW     WWWW     WWWWW
WVW    WA W  W     W W   W B W
WW     W     W    WW B   W   W
W  WW  WWWWWWW V   WWW WWW   W
W    H          WH           W
WWWWWWWWWWWWWWWWWWWWWWWWWWWWWW